25 8 25 8 25 8 25 8 25 8 25 8 25 8 25 8 25 8 27 9 27 9 27 9 27 9 27 9 27 9 27 9 27 9 27 9 27 9 27 9 27 9 27 9 27 9 27 9 27 9 32 9 32 9 32 9 32 9 32 9 32 9 32 9 32 20 32 20 32 20 32 20 32 20 32 20 32 20 32 20 
25 8 25 8 25 8 25 8 25 8 25 8 25 8 25 8 25 8 25 8 25 8 27 9 27 9 27 9 27 9 27 9 27 9 27 9 27 9 27 9 27 9 27 9 27 9 27 9 27 9 32 9 32 9 32 9 32 9 32 9 32 9 32 9 32 20 32 20 32 20 32 20 32 20 32 20 32 20 32 20 
25 8 25 8 25 8 25 8 25 8 25 8 25 8 25 8 25 8 25 8 25 8 25 8 25 8 27 9 27 9 27 9 27 9 27 9 27 9 27 9 27 9 27 9 27 9 27 9 27 9 29 18 32 9 32 9 32 9 32 9 32 9 32 9 32 20 32 20 32 20 32 20 32 20 32 20 32 20 32 20 
25 8 25 8 25 8 25 8 25 8 25 8 25 8 25 8 25 8 25 8 25 8 25 8 25 8 25 8 25 8 27 9 27 9 27 9 27 9 27 9 27 9 27 9 27 9 27 9 27 9 29 18 32 9 32 9 32 9 32 9 32 9 32 9 32 20 32 20 32 20 32 20 32 20 32 20 32 20 32 20 
25 8 25 8 25 8 25 8 25 8 25 8 25 8 25 8 25 8 25 8 25 8 25 8 25 8 25 8 25 8 25 8 25 8 27 9 27 9 27 9 27 9 27 9 27 9 27 9 27 9 27 9 29 18 32 9 32 9 32 9 32 9 32 9 32 20 32 20 32 20 32 20 32 20 32 20 32 20 32 20 
25 8 25 8 25 8 25 8 25 8 25 8 25 8 25 8 25 8 25 8 25 8 25 8 25 8 25 8 25 8 25 8 25 8 25 8 25 8 27 9 27 9 27 9 27 9 27 9 27 9 27 9 29 18 29 18 32 9 32 9 32 9 32 9 32 20 32 20 32 20 32 20 32 20 32 20 32 20 32 20 
25 8 25 8 25 8 25 8 25 8 25 8 25 8 25 8 25 8 25 8 25 8 25 8 25 8 25 8 25 8 25 8 25 8 25 8 25 8 25 8 25 8 27 9 27 9 27 9 27 9 27 9 29 18 29 18 32 9 32 9 32 9 32 9 32 20 32 20 32 20 32 20 32 20 32 20 32 20 32 20 
25 8 25 8 25 8 25 8 25 8 25 8 25 8 25 8 25 8 25 8 25 8 25 8 25 8 25 8 25 8 25 8 25 8 25 8 25 8 25 8 25 8 25 8 25 8 27 9 27 9 27 9 27 9 29 18 29 18 32 9 32 9 32 9 32 20 32 20 32 20 32 20 32 20 32 20 32 20 32 20 
25 8 25 8 25 8 25 8 25 8 25 8 25 8 25 8 25 8 25 8 25 8 25 8 25 8 25 8 25 8 25 8 25 8 25 8 25 8 25 8 25 8 25 8 25 8 25 8 25 8 27 9 27 9 29 18 29 18 29 18 32 9 32 9 32 20 32 20 32 20 32 20 32 20 32 20 32 20 32 20 
9 8 9 8 9 8 9 8 9 8 9 8 9 8 9 8 9 8 25 8 25 8 25 8 25 8 25 8 25 8 25 8 25 8 25 8 25 8 25 8 25 8 25 8 25 8 25 8 27 9 27 9 29 18 29 18 29 18 29 18 29 18 32 20 32 20 32 20 32 20 32 20 32 20 32 20 32 20 32 20 
9 8 9 8 9 8 9 8 9 8 9 8 9 8 9 8 9 8 9 8 30 20 30 20 30 20 30 20 30 20 30 20 30 20 30 20 30 20 30 20 30 20 30 20 30 20 30 20 30 20 29 18 29 18 29 18 29 18 29 18 29 18 32 20 32 20 32 20 32 20 32 20 32 20 32 20 32 20 32 20 
9 8 9 8 9 8 9 8 9 8 9 8 9 8 9 8 8 10 9 8 30 20 30 20 30 20 30 20 30 20 30 20 30 20 30 20 30 20 30 20 30 20 30 20 30 20 30 20 30 20 30 20 29 18 29 18 29 18 29 18 29 18 32 20 32 20 32 20 32 20 32 20 32 20 32 20 32 20 32 20 
9 8 9 8 9 8 9 8 9 8 9 8 9 8 8 10 8 10 8 10 30 20 30 20 30 20 30 20 30 20 30 20 30 20 30 20 30 20 30 20 30 20 30 20 30 20 30 20 30 20 30 20 29 18 29 18 29 18 29 18 29 18 32 20 32 20 32 20 32 20 32 20 32 20 32 20 32 20 32 20 
9 8 9 8 9 8 9 8 9 8 9 8 9 8 8 10 8 10 8 10 32 20 30 20 30 20 30 20 30 20 30 20 30 20 30 20 30 20 30 20 30 20 30 20 30 20 30 20 30 20 30 20 30 20 29 18 29 18 29 18 29 18 32 20 32 20 32 20 32 20 32 20 32 20 32 20 32 20 32 20 
9 8 9 8 9 8 9 8 9 8 9 8 8 10 8 10 8 10 8 10 32 20 32 20 30 20 30 20 30 20 30 20 30 20 30 20 30 20 30 20 30 20 30 20 30 20 30 20 30 20 30 20 30 20 29 18 29 18 29 18 29 18 32 20 32 20 32 20 32 20 32 20 32 20 32 20 32 20 32 20 
9 8 9 8 9 8 9 8 9 8 9 8 8 10 8 10 8 10 8 10 32 20 32 20 32 20 32 20 32 20 30 20 30 20 30 20 30 20 30 20 30 20 30 20 30 20 30 20 30 20 30 20 30 20 30 20 29 18 29 18 29 18 32 20 32 20 32 20 32 20 32 20 32 20 32 20 32 20 32 20 
9 8 9 8 9 8 9 8 9 8 8 10 8 10 8 10 8 10 8 10 32 20 32 20 32 20 32 20 32 20 32 20 32 20 32 20 30 20 30 20 30 20 30 20 30 20 30 20 30 20 30 20 30 20 30 20 29 18 29 18 29 18 32 20 32 20 32 20 32 20 32 20 32 20 32 20 32 20 32 20 
9 8 9 8 9 8 9 8 9 8 8 10 8 10 8 10 8 10 8 10 32 20 32 20 32 20 32 20 32 20 32 20 32 20 32 20 32 20 32 20 32 20 32 20 30 20 30 20 30 20 30 20 30 20 30 20 30 20 29 18 30 20 32 20 32 20 32 20 32 20 32 20 32 20 32 20 32 20 32 20 
9 8 9 8 9 8 9 8 8 10 8 10 8 10 8 10 8 10 8 10 32 20 32 20 32 20 32 20 32 20 32 20 32 20 32 20 32 20 32 20 32 20 32 20 32 20 32 20 32 20 30 20 30 20 30 20 30 20 30 20 30 20 32 20 32 20 32 20 32 20 32 20 32 20 32 20 32 20 32 20 
9 8 9 8 9 8 9 8 8 10 8 10 8 10 8 10 8 10 8 10 32 20 32 20 32 20 32 20 32 20 32 20 32 20 32 20 32 20 32 20 32 20 32 20 32 20 32 20 32 20 32 20 32 20 32 20 32 20 30 20 32 20 32 20 32 20 32 20 32 20 32 20 32 20 32 20 32 20 32 20 
9 8 9 8 9 8 8 10 8 10 8 10 8 10 8 10 8 10 8 10 32 20 32 20 32 20 32 20 32 20 32 20 32 20 32 20 32 20 32 20 32 20 32 20 32 20 32 20 32 20 32 20 32 20 32 20 32 20 32 20 32 20 32 20 32 20 32 20 32 20 32 20 32 20 32 20 32 20 32 20 
9 8 9 8 9 8 8 10 8 10 8 10 8 10 8 10 8 10 8 10 32 20 32 20 32 20 32 20 32 20 32 20 32 20 32 20 32 20 32 20 32 20 32 20 32 20 32 20 32 20 32 20 32 20 32 20 32 20 30 20 32 20 32 20 32 20 32 20 32 20 32 20 32 20 32 20 32 20 32 20 
9 32 9 32 9 32 9 32 8 30 8 30 8 30 8 30 8 30 8 30 32 20 32 20 32 20 32 20 32 20 32 20 32 20 32 20 32 20 32 20 32 20 32 20 32 20 32 20 32 20 30 20 30 20 30 20 30 20 30 20 30 20 32 20 32 20 32 20 32 20 32 20 32 20 32 20 32 20 32 20 
9 32 9 32 9 32 9 32 9 32 8 30 8 30 8 30 8 30 8 30 32 20 32 20 32 20 32 20 32 20 32 20 32 20 32 20 32 20 32 20 32 20 32 20 30 20 30 20 30 20 30 20 30 20 30 20 30 20 29 22 30 20 32 20 32 20 32 20 32 20 32 20 32 20 32 20 32 20 32 20 
9 32 9 32 9 32 9 32 9 32 8 30 8 30 8 30 8 30 8 30 32 20 32 20 32 20 32 20 32 20 32 20 32 20 32 20 30 20 30 20 30 20 30 20 30 20 30 20 30 20 30 20 30 20 30 20 29 22 29 22 29 22 32 20 32 20 32 20 32 20 32 20 32 20 32 20 32 20 32 20 
9 32 9 32 9 32 9 32 9 32 9 32 8 30 8 30 8 30 8 30 32 20 32 20 32 20 32 20 32 20 30 20 30 20 30 20 30 20 30 20 30 20 30 20 30 20 30 20 30 20 30 20 30 20 30 20 29 22 29 22 29 22 32 20 32 20 32 20 32 20 32 20 32 20 32 20 32 20 32 20 
9 32 9 32 9 32 9 32 9 32 9 32 8 30 8 30 8 30 8 30 32 20 32 20 30 20 30 20 30 20 30 20 30 20 30 20 30 20 30 20 30 20 30 20 30 20 30 20 30 20 30 20 30 20 29 22 29 22 29 22 29 22 32 20 32 20 32 20 32 20 32 20 32 20 32 20 32 20 32 20 
9 32 9 32 9 32 9 32 9 32 9 32 9 32 8 30 8 30 8 30 32 20 30 20 30 20 30 20 30 20 30 20 30 20 30 20 30 20 30 20 30 20 30 20 30 20 30 20 30 20 30 20 30 20 29 22 29 22 29 22 29 22 32 20 32 20 32 20 32 20 32 20 32 20 32 20 32 20 32 20 
9 32 9 32 9 32 9 32 9 32 9 32 9 32 8 30 8 30 8 30 30 20 30 20 30 20 30 20 30 20 30 20 30 20 30 20 30 20 30 20 30 20 30 20 30 20 30 20 30 20 30 20 29 22 29 22 29 22 29 22 29 22 32 20 32 20 32 20 32 20 32 20 32 20 32 20 32 20 32 20 
9 32 9 32 9 32 9 32 9 32 9 32 9 32 9 32 8 30 9 32 30 20 30 20 30 20 30 20 30 20 30 20 30 20 30 20 30 20 30 20 30 20 30 20 30 20 30 20 30 20 30 20 29 22 29 22 29 22 29 22 29 22 32 20 32 20 32 20 32 20 32 20 32 20 32 20 32 20 32 20 
9 32 9 32 9 32 9 32 9 32 9 32 9 32 9 32 9 32 9 32 30 20 30 20 30 20 30 20 30 20 30 20 30 20 30 20 30 20 30 20 30 20 30 20 30 20 30 20 30 20 29 22 29 22 29 22 29 22 29 22 29 22 32 20 32 20 32 20 32 20 32 20 32 20 32 20 32 20 32 20 
9 32 9 32 9 32 9 32 9 32 9 32 9 32 9 32 9 32 30 32 30 32 30 32 30 32 30 32 30 32 30 32 30 32 30 32 30 32 30 32 30 32 30 32 30 32 30 32 30 32 30 32 30 32 30 32 30 32 32 31 32 31 32 20 32 20 32 20 32 20 32 20 32 20 32 20 32 20 32 20 
30 32 30 32 30 32 30 32 30 32 30 32 30 32 30 32 30 32 30 32 30 32 30 32 30 32 30 32 30 32 30 32 30 32 30 32 30 32 30 32 30 32 30 32 30 32 30 32 30 32 30 32 30 32 30 32 30 32 30 32 32 31 32 31 32 20 32 20 32 20 32 20 32 20 32 20 32 20 32 20 
30 32 30 32 30 32 30 32 30 32 30 32 30 32 30 32 30 32 30 32 30 32 30 32 30 32 30 32 30 32 30 32 30 32 30 32 30 32 30 32 30 32 30 32 30 32 30 32 30 32 30 32 30 32 30 32 32 31 32 31 32 31 32 31 32 20 32 20 32 20 32 20 32 20 32 20 32 20 32 20 
30 32 30 32 30 32 30 32 30 32 30 32 30 32 30 32 30 32 30 32 30 32 30 32 30 32 30 32 30 32 30 32 30 32 30 32 30 32 30 32 30 32 30 32 30 32 30 32 30 32 30 32 32 31 32 31 32 31 32 31 32 31 32 31 32 20 32 20 32 20 32 20 32 20 32 20 32 20 32 20 
30 32 30 32 30 32 30 32 30 32 30 32 30 32 30 32 30 32 30 32 30 32 30 32 30 32 30 32 30 32 30 32 30 32 30 32 30 32 30 32 30 32 30 32 30 32 30 32 32 31 32 31 32 31 32 31 32 31 32 31 32 31 32 31 32 20 32 20 32 20 32 20 32 20 32 20 32 20 32 20 
30 32 30 32 30 32 30 32 30 32 30 32 30 32 30 32 30 32 30 32 30 32 30 32 30 32 30 32 30 32 30 32 30 32 30 32 30 32 30 32 30 32 30 32 32 31 32 31 32 31 32 31 32 31 32 31 32 31 32 31 32 31 32 31 32 20 32 20 32 20 32 20 32 20 32 20 32 20 32 20 
30 32 30 32 30 32 30 32 30 32 30 32 30 32 30 32 30 32 30 32 30 32 30 32 30 32 30 32 30 32 30 32 30 32 30 32 30 32 30 32 32 31 32 31 32 31 32 31 32 31 32 31 32 31 32 31 32 31 32 31 32 31 32 31 32 20 32 20 32 20 32 20 32 20 32 20 32 20 32 20 
30 32 30 32 30 32 30 32 30 32 30 32 30 32 30 32 30 32 30 32 30 32 30 32 30 32 30 32 30 32 30 32 30 32 30 32 32 31 32 31 32 31 32 31 32 31 32 31 32 31 32 31 32 31 32 31 32 31 32 31 32 31 32 31 32 20 32 20 32 20 32 20 32 20 32 20 32 20 32 20 
30 32 30 32 30 32 30 32 30 32 30 32 30 32 30 32 30 32 30 32 30 32 30 32 30 32 30 32 30 32 30 32 32 31 32 31 32 31 32 31 32 31 32 31 32 31 32 31 32 31 32 31 32 31 32 31 32 31 32 31 32 31 32 31 32 20 32 20 32 20 32 20 32 20 32 20 32 20 32 20 
